1  1  1  1  1  1  1  1  1  1  1  1  1  1  1  1  1  1  1  1  1  1  1  1  1  1  1  1  1  1  1  1  1  1  1  1  1  1  1  1  1  1  1  1  1  1  1  1  1  1
1  1  1  1  1  1  1  1  1  1  1  1  1  1  1  1  1  1  1  1  1  1  1  1  1  1  1  1  1  1  1  1  1  1  1  1  1  1  1  1  1  1  1  1  1  1  1  1  1  1
1  1  1  1  1  1  1  1  1  1  1  1  1  1  1  1  1  1  1  1  1  1  1  1  1  1  1  1  1  1  1  1  1  1  1  1  1  1  1  1  1  1  1  1  1  1  1  1  1  1
1  1  1  1  1  1  1  1  1  1  1  1  1  1  1  1  1  1  1  1  1  1  1  1  1  1  1  1  1  1  1  1  1  1  1  1  1  1  1  1  1  1  1  1  1  1  1  1  1  1
1  1  1  1  1  1  1  1  1  1  1  1  1  1  1  1  1  1  1  1  1  1  1  1  1  1  1  1  1  1  1  1  1  1  1  1  1  1  1  1  1  1  1  1  1  1  1  1  1  1
1  1  1  1  1  1  1  1  1  1  1  1  1  1  1  1  1  1  1  1  1  1  1  1  1  13 1  1  1  1  1  1  1  1  1  1  1  1  1  1  1  1  1  1  1  1  1  1  1  1
1  1  1  1  1  1  1  1  1  1  1  1  1  1  1  1  1  1  1  1  1  1  1  1  0  23 1  1  1  1  1  1  1  1  1  1  1  1  1  1  1  1  1  1  1  1  1  1  1  1
1  1  1  1  1  1  1  1  1  1  1  1  1  1  1  1  1  1  1  1  1  1  1  0  10 22 1  1  1  1  1  1  1  1  1  10 41 41 41 1  1  1  1  1  1  1  1  1  1  1
1  1  1  1  1  1  1  1  1  1  1  1  1  1  1  1  1  1  1  1  1  1  0  0  20 32 0  1  1  1  1  1  1  1  10 32 0  0  1  1  1  1  1  1  1  1  1  1  1  1
1  1  1  1  1  1  1  1  1  1  1  1  1  1  1  1  1  1  1  1  1  1  0  10 32 0  0  0  1  1  1  1  1  1  23 0  1  1  1  1  1  1  1  1  1  1  1  1  1  1
1  1  1  1  1  1  1  1  1  1  1  1  1  1  1  1  1  1  1  1  1  10 41 32 0  0  43 0  1  1  1  1  1  1  23 0  1  1  1  1  1  1  1  1  1  1  1  1  1  1
1  1  1  1  1  1  1  1  1  1  1  1  1  1  1  1  1  1  1  1  0  23 0  0  0  0  0  0  0  1  1  1  1  1  23 0  1  1  1  1  1  1  1  1  1  1  1  1  1  1
1  1  1  1  1  1  1  1  1  1  1  1  1  1  1  1  1  0  0  0  0  23 0  0  0  43 0  0  1  1  1  1  1  0  23 0  0  1  1  1  1  1  1  1  1  1  1  1  1  1
15 15 16 1  1  1  1  1  1  1  1  1  1  0  0  0  0  0  0  0  0  23 0  0  0  0  1  1  1  1  1  1  0  0  23 0  0  0  1  1  1  1  1  1  1  1  1  1  1  1
25 25 25 15 16 1  1  1  1  1  1  1  0  0  10 41 41 41 41 41 11 32 0  0  1  1  1  1  1  1  1  1  1  0  30 41 12 0  0  0  1  1  1  1  1  1  1  1  1  1
25 25 25 25 25 15 15 16 1  1  1  0  0  0  23 2  2  2  2  2  23 0  0  1  1  1  1  1  1  1  1  1  1  0  0  0  30 12 0  0  0  1  1  1  1  1  1  1  1  1
25 25 25 25 25 25 25 26 0  1  1  0  0  0  23 58 54 55 56 59 23 0  1  1  1  1  1  1  1  1  1  1  1  1  1  0  0  23 0  47 0  1  1  1  1  1  1  1  1  1
25 25 25 25 25 25 25 26 0  1  1  0  0  0  23 58 64 65 56 59 23 0  1  1  1  1  1  1  1  1  1  1  1  1  1  1  1  23 0  0  0  1  1  1  1  1  1  1  1  1
25 25 25 25 25 25 25 26 0  0  0  0  0  0  23 68 66 67 67 69 23 0  1  1  1  1  1  1  1  1  1  1  1  1  1  1  1  23 0  0  0  1  1  1  1  1  1  1  1  1
25 25 25 25 25 25 25 26 0  0  0  0  0  0  20 41 31 41 41 41 32 1  1  1  1  1  1  1  1  1  1  1  1  1  1  1  1  23 0  0  0  1  1  1  1  1  1  1  1  1
25 25 25 25 25 25 25 36 0  1  1  0  0  0  23 0  0  0  0  0  0  1  1  1  1  1  1  1  1  1  1  1  1  1  1  1  0  23 0  0  0  1  1  1  1  1  1  1  1  1
25 25 25 25 25 25 26 0  0  1  1  0  0  0  23 0  0  0  0  0  1  1  1  1  1  1  1  1  1  1  1  1  1  1  1  1  0  23 0  0  0  1  1  1  1  1  1  1  1  1
25 25 25 25 25 35 36 0  1  1  1  1  0  0  23 0  0  0  0  0  1  1  1  1  1  1  1  1  1  1  1  1  1  1  1  1  0  23 0  0  1  1  1  1  1  1  1  1  1  1
25 25 25 35 36 1  1  1  1  1  1  1  1  0  23 0  0  0  0  0  1  1  1  1  1  1  1  1  1  1  1  1  1  1  0  0  0  23 0  0  1  1  1  1  1  1  1  1  1  1
35 35 36 1  1  1  1  1  1  1  1  1  1  0  23 0  0  0  0  1  1  1  1  1  1  1  1  1  1  1  1  1  1  0  0  10 41 32 0  1  1  1  1  1  1  1  1  1  1  1
1  1  1  1  1  1  1  1  1  1  0  0  0  0  23 0  0  0  0  1  1  1  1  1  1  1  1  1  1  1  1  1  0  0  10 32 0  1  1  1  1  1  1  1  1  1  1  1  1  1
1  1  1  1  1  1  1  1  1  0  0  0  0  0  23 0  0  0  0  1  1  1  1  1  1  1  1  1  1  1  1  1  0  10 32 0  1  1  1  1  1  1  1  1  1  1  1  1  1  1
1  1  1  1  1  1  1  1  0  0  0  0  0  0  23 0  0  0  0  0  1  1  1  1  1  1  1  1  1  1  1  0  0  23 0  1  1  1  1  1  1  1  1  1  1  1  1  1  1  1
1  1  1  1  1  1  1  1  0  0  0  0  0  0  23 0  0  0  0  0  1  1  1  1  1  1  1  1  1  1  0  0  0  23 0  1  1  1  1  1  1  1  1  1  1  1  1  1  1  1
1  1  1  1  1  1  1  1  0  10 41 41 41 41 22 0  0  0  0  0  0  1  1  1  1  1  1  1  1  0  0  0  10 32 0  1  1  1  1  1  1  1  1  1  1  1  1  1  1  1
1  1  1  1  1  1  1  1  0  23 18 2  2  19 23 0  0  0  0  47 0  1  1  1  1  1  1  1  1  0  0  10 32 0  0  1  1  1  1  1  1  1  1  1  1  1  1  1  1  1
1  1  1  1  1  1  1  1  0  23 28 50 51 29 23 0  0  0  0  0  0  0  1  1  1  1  1  1  0  0  10 32 0  0  0  0  1  1  1  1  1  1  1  1  1  1  1  1  1  1
1  1  1  1  1  1  1  1  0  23 28 60 61 29 23 0  0  0  0  0  0  0  0  0  0  0  0  0  0  0  23 0  0  0  0  0  0  1  1  1  1  1  1  1  1  1  1  1  1  1
1  1  1  1  1  1  1  1  0  23 28 10 12 29 20 41 41 41 41 41 41 11 41 41 41 41 41 41 41 41 32 0  0  0  0  0  0  0  0  1  1  1  1  1  1  1  1  1  1  1
1  1  1  1  1  1  1  1  0  23 38 20 22 39 23 0  0  0  0  0  0  23 0  0  0  0  0  0  0  0  0  0  0  0  0  0  0  43 0  0  0  1  1  1  1  1  1  1  1  1
1  1  1  1  1  1  1  1  0  30 41 31 31 41 32 0  0  0  0  0  0  23 0  0  0  0  0  0  0  0  18 2  2  2  2  19 0  0  0  0  0  0  1  1  1  1  1  1  1  1
1  1  1  1  1  1  1  1  0  0  0  0  0  0  0  0  0  0  0  0  0  23 0  0  0  0  43 0  0  0  28 50 51 0  0  29 0  0  0  0  0  0  1  1  1  1  1  1  1  1
1  1  1  1  1  1  1  1  0  0  0  0  0  0  0  0  0  0  0  0  0  23 0  0  0  0  0  0  0  0  28 60 61 0  0  29 0  0  0  0  0  0  1  1  1  1  1  1  1  1
1  1  1  1  1  1  1  1  0  0  0  0  0  0  0  0  0  0  0  0  10 22 0  0  0  0  0  0  0  0  38 2  13 2  2  39 0  0  0  0  0  0  1  1  1  1  1  1  1  1
1  1  1  1  1  1  1  1  0  10 41 41 41 41 11 41 41 41 41 11 31 31 41 41 11 41 41 41 41 41 41 41 32 0  0  0  0  0  0  0  47 0  1  1  1  1  1  1  1  1
1  1  1  1  1  1  1  1  0  23 18 2  2  19 23 18 2  2  19 23 18 2  2  19 23 18 2  2  19 0  0  0  0  0  0  0  0  0  0  0  0  0  1  1  1  1  1  1  1  1
1  1  1  1  1  1  1  1  0  23 28 52 53 29 23 28 50 51 29 23 28 52 53 29 23 28 50 51 29 0  0  0  0  0  0  0  0  0  0  0  0  0  1  1  1  1  1  1  1  1
1  1  1  1  1  1  1  1  0  23 28 62 63 29 23 28 60 61 29 23 28 62 63 29 23 28 60 61 29 0  0  0  0  0  0  0  3  3  3  3  0  0  1  1  1  1  1  1  1  1
1  1  1  1  1  1  1  1  0  23 38 13 2  39 23 38 13 2  39 23 38 13 2  39 23 38 13 2  39 0  0  0  0  0  0  0  3  3  3  3  0  0  1  1  1  1  1  1  1  1
1  1  1  1  1  1  1  1  0  30 41 32 0  0  30 41 32 0  0  30 41 32 0  0  30 41 32 0  0  0  0  0  0  0  0  0  3  3  3  3  0  0  1  1  1  1  1  1  1  1
1  1  1  1  1  1  1  1  0  0  0  0  0  0  0  0  0  0  0  0  0  0  0  0  0  0  0  0  0  0  0  0  0  0  0  0  3  3  3  3  0  0  1  1  1  1  1  1  1  1
1  1  1  1  1  1  1  1  0  0  0  0  0  0  0  0  0  0  0  0  0  0  0  0  0  0  0  0  0  0  0  0  0  0  0  0  3  3  3  3  0  0  1  1  1  1  1  1  1  1
1  1  1  1  1  1  1  1  0  0  0  0  0  0  0  0  0  0  0  0  0  0  0  0  0  0  0  0  0  0  0  0  0  0  0  0  3  3  3  3  0  0  1  1  1  1  1  1  1  1
1  1  1  1  1  1  1  1  0  0  0  0  0  0  3  3  3  3  3  3  3  3  3  3  3  0  0  0  0  0  0  0  0  0  0  0  3  3  3  3  0  0  1  1  1  1  1  1  1  1
1  1  1  1  1  1  1  1  0  0  0  0  0  0  3  3  3  3  3  3  3  3  3  3  3  0  0  0  0  0  0  0  0  0  0  0  3  3  3  3  0  0  1  1  1  1  1  1  1  1
1  1  1  1  1  1  1  1  0  0  0  0  0  0  3  3  3  3  3  3  3  3  3  3  3  0  0  0  0  0  0  0  0  0  47 0  3  3  3  3  0  0  1  1  1  1  1  1  1  1
1  1  1  1  1  1  1  1  0  0  0  0  0  0  3  3  3  3  3  3  3  3  3  3  3  0  0  0  0  0  0  0  0  0  0  0  3  3  3  3  0  0  1  1  1  1  1  1  1  1
1  1  1  1  1  1  1  1  0  0  0  0  0  0  0  0  0  0  0  0  0  0  0  0  0  0  0  0  0  0  0  0  0  0  0  0  3  3  3  3  0  0  1  1  1  1  1  1  1  1
1  1  1  1  1  1  1  1  0  0  0  0  0  0  0  0  0  0  0  0  0  0  0  0  0  0  0  0  0  0  0  0  0  0  0  0  3  3  3  3  0  0  1  1  1  1  1  1  1  1
1  1  1  1  1  1  1  1  0  0  0  0  47 0  0  0  0  0  0  0  0  0  0  0  0  0  0  0  0  0  0  0  0  0  0  0  0  0  0  0  0  0  1  1  1  1  1  1  1  1
1  1  1  1  1  1  1  1  0  0  0  0  0  0  0  0  0  0  0  0  0  0  0  0  0  0  0  0  0  0  0  0  0  0  0  0  0  0  0  0  0  0  1  1  1  1  1  1  1  1
1  1  1  1  1  1  1  1  0  0  0  0  0  0  0  0  0  0  1  1  1  1  1  0  0  0  0  0  0  0  0  0  1  1  1  0  0  43 0  0  0  0  1  1  1  1  1  1  1  1
1  1  1  1  1  1  1  1  0  0  0  0  0  0  1  1  1  1  1  1  1  1  1  1  1  0  0  0  0  0  1  1  1  1  1  1  1  0  0  0  0  0  1  1  1  1  1  1  1  1
1  1  1  1  1  1  1  1  0  0  0  0  0  1  1  1  1  1  0  0  0  0  0  1  1  1  0  0  0  1  1  1  0  0  0  1  1  1  0  0  0  0  1  1  1  1  1  1  1  1
1  1  1  1  1  1  1  1  0  0  0  0  1  1  1  0  0  0  0  0  0  0  0  0  0  1  1  1  1  1  0  0  0  0  0  0  0  1  1  1  1  0  1  1  1  1  1  1  1  1
1  1  1  1  1  1  1  1  0  0  0  0  1  1  0  0  0  0  0  0  0  0  0  0  0  0  1  1  1  0  0  0  0  0  0  0  0  0  1  1  1  1  1  1  1  1  1  1  1  1
1  1  1  1  1  1  1  1  0  0  0  0  1  1  0  0  0  0  0  0  0  0  0  0  0  0  0  0  0  0  0  0  0  0  0  0  0  0  0  0  0  1  1  1  1  1  1  1  1  1
1  1  1  1  1  1  1  1  0  0  0  0  0  0  0  0  0  0  0  0  0  0  0  0  0  0  0  0  0  0  0  0  0  0  0  0  0  0  0  0  0  0  1  1  1  1  1  1  1  1
1  1  1  1  1  1  1  1  0  0  0  0  0  0  0  0  0  1  1  1  0  0  0  0  0  0  0  0  0  0  0  0  0  0  0  0  0  0  0  0  0  0  1  1  1  1  1  1  1  1
1  1  1  1  1  1  1  1  0  0  0  0  0  0  0  0  1  1  1  1  1  1  0  0  0  0  0  0  0  0  0  0  0  0  0  0  0  1  1  1  0  1  1  1  1  1  1  1  1  1
1  1  1  1  1  1  1  1  0  0  0  0  0  0  1  1  1  0  0  0  1  1  1  1  1  0  0  0  0  0  0  0  0  0  0  0  1  0  0  1  1  1  1  1  1  1  1  1  1  1
1  1  1  1  1  1  1  1  0  0  0  0  1  1  1  1  0  0  0  0  0  0  0  0  1  1  1  0  0  0  0  0  0  0  0  1  0  0  0  0  1  1  1  1  1  1  1  1  1  1
1  1  1  1  1  1  1  1  0  1  1  1  1  1  1  1  0  0  0  0  0  0  0  0  0  0  1  1  1  0  0  0  0  0  0  1  0  0  0  0  0  1  1  1  1  1  1  1  1  1
1  1  1  1  1  1  1  1  1  1  1  0  0  1  1  1  0  0  0  0  1  1  0  0  0  0  0  0  1  1  1  0  0  0  0  0  0  0  1  0  0  0  1  1  1  1  1  1  1  1
1  1  1  1  1  1  1  1  1  0  0  0  0  0  1  1  1  0  0  0  0  1  1  0  0  0  0  0  0  0  1  1  0  0  0  0  0  1  1  0  0  0  1  1  1  1  1  1  1  1
1  1  1  1  1  1  1  1  1  0  0  0  0  0  0  1  1  0  0  0  0  0  1  0  0  0  0  0  0  0  0  1  1  0  0  0  1  1  0  0  0  0  1  1  1  1  1  1  1  1
1  1  1  1  1  1  1  1  1  0  0  0  0  0  0  0  1  1  0  0  0  0  0  1  1  1  1  0  0  0  0  0  1  1  1  1  1  1  0  0  0  1  1  1  1  14 15 15 15 15
1  1  1  1  1  1  1  1  1  1  0  0  0  0  0  0  0  1  1  0  0  0  0  0  0  1  1  1  0  0  0  0  0  0  0  0  0  0  0  0  0  1  1  1  14 25 25 25 25 25
1  1  1  1  1  1  1  1  1  1  1  0  0  0  0  0  0  0  0  0  0  0  0  0  0  0  0  1  1  0  0  0  0  0  0  0  0  0  0  0  1  14 15 15 25 25 25 25 25 25
1  1  1  1  1  1  1  1  1  1  1  1  1  1  0  0  0  0  0  0  0  1  1  1  1  1  1  1  1  1  1  1  0  0  0  0  0  0  0  1  14 25 25 25 25 25 25 25 25 25
1  1  1  1  1  1  1  1  1  1  1  1  1  1  1  1  1  1  1  1  1  1  1  1  1  1  1  1  1  1  1  1  1  1  1  1  1  1  14 15 25 25 25 25 25 25 25 25 25 25
1  1  1  1  1  1  1  1  1  1  1  1  1  1  1  1  1  1  1  1  1  1  1  1  1  1  1  1  1  1  1  1  1  1  1  1  1  1  24 25 25 25 25 25 25 25 25 25 25 25
1  1  1  1  1  1  1  1  1  1  1  1  1  1  1  1  1  1  1  1  1  1  1  1  1  1  1  1  1  1  1  1  1  1  1  1  1  14 25 25 25 25 25 25 25 25 25 25 25 25
1  1  1  1  1  1  1  1  1  1  1  1  1  1  1  1  1  1  1  1  1  1  1  1  1  1  1  1  1  1  1  1  1  1  1  1  1  24 25 25 25 25 25 25 25 25 25 25 25 25
1  1  1  1  1  1  1  1  1  1  1  1  1  1  1  1  1  1  1  1  1  1  1  1  1  1  1  1  1  1  1  1  1  1  1  1  1  24 25 25 25 25 25 25 25 25 25 25 25 25